#########################################
#S    #     #               #     #   # #
##### # ##### ##### ####### # ### # # # #
#     #     # # #   #     #   # # # #   #
# ######### # # # # ##### ##### # # ### #
# #       # #   # # #   #     #   # #   #
# # ### # # # ### # # # # ### # ### ### #
# # #   # #   #   # # # # #   # #     # #
# # # ### ##### ##### # ### ### # ### # #
# # # # #     #   #   #   #     #   # # #
# ### # ##### ### # ##### # ####### # ###
# #   #     #   # # #   # # #   #   #   #
# # ### ### ### # # # # # # # # ### ### #
#   #   #     # #     # # #   #   #   # #
##### ####### # ######### ####### # ### #
# #         # #         #   #   # # #   #
# # ####### ########### # # ### # # # # #
# #       #   #         # #   # # # # # #
# ####### ### # ############# # # ### # #
#           #                 #       #E#
#########################################