#########################################
#S#       #     #     #       #         #
# ##### # # # # # ### # ### # ##### # # #
# #   # # # # # # # #   #   #     # # # #
# # # # # # # ### # ##### ####### ### # #
# # # # #   # #   # #   #     #       # #
# # # # ##### # ### # # ##### ###########
#   # #   # #   #   # #   # # #         #
##### ### # ####### # # # # # # ####### #
#   # #           #   # #   #     #     #
# ### ########### ##### ########### ### #
#   #     #     # #   #   #     #   # # #
### ##### ### # # # # ### # ### # ### # #
#       # #   # #   #     # #   # #   # #
# ##### # # ############# # ### # # # # #
# #     # #               #   #   # # # #
# ####### # ############### # ##### ### #
#         #   #     #     # #   #   #   #
# ############# ### # ### ##### # # # ###
#               #     #         # #    E#
#########################################